OOOOOOOOOOOOOOOOOOOOOOOOOOOOOOOOOOOOOOOOOOOOOOOOO#
OOOOOOOOOOOOOOOOOOOOOOOOOOOOOOOOOOOOOOOOOOOOOOOOO#
OOOOOOOOOOOOOOOOOOOOOOOOOOOOOOOOOOOOOOOOOOOOOOOOO#
OOOOOOOOOOOOOOOOOOOOOOOOOOOOOOOOOOOOOOOOOOOOOOOOO#
OOOOOOOOOOOOOOOOOOOOOOOOOOOOOOOOOOOOOOOOOOOOOOOOO#
OOOOOOOOOOOOOOOOOOOOOOOOOOOOOOOOOOOOOOOOOOOOOOOOO#
OOOOOOOOOOOOOOOOOOOOOOOOOOOOOOOOOOOOOOOOOOOOOOOOO#
OOOOOOOOOOOOOOOOOOOOOOOOOOOOOOOOOOOOOOOOOOOOOOOOO#
OOOOOOOOOOOOOOOOOOOOOOOOOOOOOOOOOOOOOOOOOOOOOOOOO#
OOOOOOOOOOOOOOOOOOOOOOOOOOOOOOOOOOOOOOOOOOOOOOOOO#
OOOOOOOOOOOOOOOOOOOOOOOOOOOOOOOOOOOOOOOOOOOOOOOOO#
OOOOOOOOOOOOO########OOOOOOOOOOOOOOOOOOOOOOOOOOOO#
OOOOOOOOOOOOO####D###OOOOOOOOOOOOOOOOOOOOOOOOOOOO#
OOOOOOOOOOOOO####O#########OOOOOOOOOOOOOOOOOOOOOO#
OOOOOOOOOOOOO#OOOOOO#OOOOO#OOOOOOOOOOOOOOOOOOOOOO#
OOOOOOOOOOOOO#OOOOOO#######OOOOOOOOOOOOOOOOOOOOOO#
OOOOOOOOOOOOO#OOOOOOOO##OO#OOOOOOOOOOOOOOOOOOOOOO#
OOOOOOOOOOOOO#OOOEOOOOOOOO#OOOOOOOOOOOOOOOOOOOOOO#
OOOOOOOOOOOOO#OOOOOOOOEOOO#OOOOOOOOOOOOOOOOOOOOOO#
OOOOOOOOOOOOO#OOOOOOOOOOOO###OOOOOOOOOOOOOOOOOOOO#
OOOOOOOOOOOOO#######OOOOOO#O#OOOOOOOOOOOOOOOOOOOO#
OOOOOOOOOOOOOOOOOOO#OOOOOO###OOOOOOOOOOOOOOOOOOOO#
OOOOOOOOOOOOOOOOOOO###OOOO#O#OOOOOOOOOOOOOOOOOOOO#
OOOOOOOOOOOOOOOOOOOOO#OOEOOO#OOOOOOOOOOOOOOOOOOOO#
OOOOOOOOOOOOOOOOOOOOO#OOOOOO#OOOOOOOOOOOOOOOOOOOO#
OOOOOOOOOOOOOOOOOOOOO#OOONOO#OOOOOOOOOOOOOOOOOOOO#
OOOOOOOOOOOOOOOOOOOOO#OOOEOO#OOOOOOOOOOOOOOOOOOOO#
OOOOOOOOOOOOOOOOOOOOO#OOOOOO#OOOOOOOOOOOOOOOOOOOO#
OOOOOOOOOOOOOOOOOOOOO########OOOOOOOOOOOOOOOOOOOO#
OOOOOOOOOOOOOOOOOOOOOOOOOOOOOOOOOOOOOOOOOOOOOOOOO#
OOOOOOOOOOOOOOOOOOOOOOOOOOOOOOOOOOOOOOOOOOOOOOOOO#
OOOOOOOOOOOOOOOOOOOOOOOOOOOOOOOOOOOOOOOOOOOOOOOOO#
OOOOOOOOOOOOOOOOOOOOOOOOOOOOOOOOOOOOOOOOOOOOOOOOO#
OOOOOOOOOOOOOOOOOOOOOOOOOOOOOOOOOOOOOOOOOOOOOOOOO#
OOOOOOOOOOOOOOOOOOOOOOOOOOOOOOOOOOOOOOOOOOOOOOOOO#
OOOOOOOOOOOOOOOOOOOOOOOOOOOOOOOOOOOOOOOOOOOOOOOOO#
OOOOOOOOOOOOOOOOOOOOOOOOOOOOOOOOOOOOOOOOOOOOOOOOO#
OOOOOOOOOOOOOOOOOOOOOOOOOOOOOOOOOOOOOOOOOOOOOOOOO#
OOOOOOOOOOOOOOOOOOOOOOOOOOOOOOOOOOOOOOOOOOOOOOOOO#
OOOOOOOOOOOOOOOOOOOOOOOOOOOOOOOOOOOOOOOOOOOOOOOOO#
OOOOOOOOOOOOOOOOOOOOOOOOOOOOOOOOOOOOOOOOOOOOOOOOO#
OOOOOOOOOOOOOOOOOOOOOOOOOOOOOOOOOOOOOOOOOOOOOOOOO#
OOOOOOOOOOOOOOOOOOOOOOOOOOOOOOOOOOOOOOOOOOOOOOOOO#
OOOOOOOOOOOOOOOOOOOOOOOOOOOOOOOOOOOOOOOOOOOOOOOOO#
OOOOOOOOOOOOOOOOOOOOOOOOOOOOOOOOOOOOOOOOOOOOOOOOO#
OOOOOOOOOOOOOOOOOOOOOOOOOOOOOOOOOOOOOOOOOOOOOOOOO#
OOOOOOOOOOOOOOOOOOOOOOOOOOOOOOOOOOOOOOOOOOOOOOOOO#
OOOOOOOOOOOOOOOOOOOOOOOOOOOOOOOOOOOOOOOOOOOOOOOOO#
OOOOOOOOOOOOOOOOOOOOOOOOOOOOOOOOOOOOOOOOOOOOOOOOO#
OOOOOOOOOOOOOOOOOOOOOOOOOOOOOOOOOOOOOOOOOOOOOOOOO#
