OOOOOOOOOOOOOOOOOOOOOOOOOOOOOOOOOOOOOOOOOOOOOOOOO#
OOOOOOOOOOOOOOOOOOOOOOOOOOOOOOOOOOOOOOOOOOOOOOOOO#
OOOOOOOOOOOOOOOOOOOOOOOOOOOOOOOOOOOOOOOOOOOOOOOOO#
OOOOOOOOOOOOOOOOOOOOOOOOOOOOOOOOOOOOOOOOOOOOOOOOO#
OOOOOOOOOOOOOOOOOOOOOOOOOOOOOOOOOOOOOOOOOOOOOOOOO#
OOOOOOOOOOOOOOOOOOOOOOOOOOOOOOOOOOOOOOOOOOOOOOOOO#
OOOOOOOOOOOOOOOOOOOOOOOOOOOOOOOOOOOOOOOOOOOOOOOOO#
OOOOOOOOOOOOOOOOOOOOOOOOOOOOOOOOOOOOOOOOOOOOOOOOO#
OOOOOOOOOOOOOOOOOOOOOOOOOOOOOOOOOOOOOOOOOOOOOOOOO#
OOOOOOOOOOOOOOOOOOOOOOOOOOOOOOOOOOOOOOOOOOOOOOOOO#
OOOOOOOOOOOOOOOOOOOOOOOOOOOOOOOOOOOOOOOOOOOOOOOOO#
OOOOOOOOOOOOOOOOOOOOOOOOOOOOOOOOOOOOOOOOOOOOOOOOO#
OOOOOOOOOOOOOOOOOOOOOOOO###########OOOOOOOOOOOOOO#
OOOOOOOOOOOOOOOOOOOOOOOO###########OOOOOOOOOOOOOO#
OOOOOOOOOOOOOOOOOOOOOOOO###########OOOOOOOOOOOOOO#
OOOOOOOOOOOOOOOOOOOOOOOO#OOOOOO####OOOOOOOOOOOOOO#
OOOOOOOOOOOOOOOOOOOO#####OOEOO#####OOOOOOOOOOOOOO#
OOOOOOOOOOOOOOOOOOOO#####OOOOO#####OOOOOOOOOOOOOO#
OOOOOOOOOOOOOOOOOOOO#####OOOOOO####OOOOOOOOOOOOOO#
OOOOOOOOOOOOOOOOOOOO#OOOOOO##OO####OOOOOOOOOOOOOO#
OOOOOOOOOOOOOOOOOOOO#OOEOOO##OO#OOOOOOOOOOOOOOOOO#
OOOOOOOOOOOOOOOOOOOO#ONOOOO##OO#OOOOOOOOOOOOOOOOO#
OOOOOOOOOOOOOOOOOOOO#OOOOOO##OO#OOOOOOOOOOOOOOOOO#
OOOOOOOOOOOOOOOOOOOO#OOOEOOOOOO#OOOOOOOOOOOOOOOOO#
OOOOOOOOOOOOOOOOOOO##OOOOOOOOOO#OOOOOOOOOOOOOOOOO#
OOOOOOOOOOOOOOOOOOO#DOOOOO######OOOOOOOOOOOOOOOOO#
OOOOOOOOOOOOOOOOOOO##OOEOO#OOOOOOOOOOOOOOOOOOOOOO#
OOOOOOOOOOOOOOOOOOOO#OOOOO#OOOOOOOOOOOOOOOOOOOOOO#
OOOOOOOOOOOOOOOOOOOO#######OOOOOOOOOOOOOOOOOOOOOO#
OOOOOOOOOOOOOOOOOOOOOOOOOOOOOOOOOOOOOOOOOOOOOOOOO#
OOOOOOOOOOOOOOOOOOOOOOOOOOOOOOOOOOOOOOOOOOOOOOOOO#
OOOOOOOOOOOOOOOOOOOOOOOOOOOOOOOOOOOOOOOOOOOOOOOOO#
OOOOOOOOOOOOOOOOOOOOOOOOOOOOOOOOOOOOOOOOOOOOOOOOO#
OOOOOOOOOOOOOOOOOOOOOOOOOOOOOOOOOOOOOOOOOOOOOOOOO#
OOOOOOOOOOOOOOOOOOOOOOOOOOOOOOOOOOOOOOOOOOOOOOOOO#
OOOOOOOOOOOOOOOOOOOOOOOOOOOOOOOOOOOOOOOOOOOOOOOOO#
OOOOOOOOOOOOOOOOOOOOOOOOOOOOOOOOOOOOOOOOOOOOOOOOO#
OOOOOOOOOOOOOOOOOOOOOOOOOOOOOOOOOOOOOOOOOOOOOOOOO#
OOOOOOOOOOOOOOOOOOOOOOOOOOOOOOOOOOOOOOOOOOOOOOOOO#
OOOOOOOOOOOOOOOOOOOOOOOOOOOOOOOOOOOOOOOOOOOOOOOOO#
OOOOOOOOOOOOOOOOOOOOOOOOOOOOOOOOOOOOOOOOOOOOOOOOO#
OOOOOOOOOOOOOOOOOOOOOOOOOOOOOOOOOOOOOOOOOOOOOOOOO#
OOOOOOOOOOOOOOOOOOOOOOOOOOOOOOOOOOOOOOOOOOOOOOOOO#
OOOOOOOOOOOOOOOOOOOOOOOOOOOOOOOOOOOOOOOOOOOOOOOOO#
OOOOOOOOOOOOOOOOOOOOOOOOOOOOOOOOOOOOOOOOOOOOOOOOO#
OOOOOOOOOOOOOOOOOOOOOOOOOOOOOOOOOOOOOOOOOOOOOOOOO#
OOOOOOOOOOOOOOOOOOOOOOOOOOOOOOOOOOOOOOOOOOOOOOOOO#
OOOOOOOOOOOOOOOOOOOOOOOOOOOOOOOOOOOOOOOOOOOOOOOOO#
OOOOOOOOOOOOOOOOOOOOOOOOOOOOOOOOOOOOOOOOOOOOOOOOO#
OOOOOOOOOOOOOOOOOOOOOOOOOOOOOOOOOOOOOOOOOOOOOOOOO#
