OOOOOOOOOOOOOOOOOOOOOOOOOOOOOOOOOOOOOOOOOOOOOOOOO#
OOOOOOOOOOOOOOOOOOOOOOOOOOOOOOOOOOOOOOOOOOOOOOOOO#
OOOOOOOOOOOOOOOOOOOOOOOOOOOOOOOOOOOOOOOOOOOOOOOOO#
OOOOOOOOOOOOOOOOOOOOOOOOOOOOOOOOOOOOOOOOOOOOOOOOO#
OOOOOOOOOOOOOOOOOOOOOOOOOOOOOOOOOOOOOOOOOOOOOOOOO#
OOOOOOOOOOOOOOOOOOOOOOOOOOOOOOOOOOOOOOOOOOOOOOOOO#
OOOOOOOOOOOOOOOOOOOOOOOOOOOOOOOOOOOOOOOOOOOOOOOOO#
OOOOOOOOOOOOOOOOOOOOOOOOOOOOOOOOOOOOOOOOOOOOOOOOO#
OOOOOOOOOOOOOOOOOOOOOOOOOOOOOOOOOOOOOOOOOOOOOOOOO#
OOOOOOOOOOOOOOOOOOOOOOOOOOOOOOOOOOOOOOOOOOOOOOOOO#
OOOOOOOOOOOOOOOOOOOOOOOOOOOOOOOOOOOOOOOOOOOOOOOOO#
OOOOOOOOOOOOOOOOOOOOOOOOOOOOOOOOOOOOOOOOOOOOOOOOO#
OOOOOOOOOOOOOOOOOOOOOOOOOOOOOOOOOOOOOOOOOOOOOOOOO#
OOOOOOOOOOOOOOOOOOOOOOOOOOOOOOOOOOOOOOOOOOOOOOOOO#
OOOOOOOOOOOOOOOOOOOOOOOOOOOOOOOOOOOOOOOOOOOOOOOOO#
OOOOOOOOOOOOOOOOOOOOOOOOOOOOOOOOOOOOOOOOOOOOOOOOO#
OOOOOOOOOOOOOOOOOOO############OOOOOOOOOOOOOOOOOO#
OOOOOOOOOOOOOOOOOOO############OOOOOOOOOOOOOOOOOO#
OOOOOOOOOOOOOOOOOOO####D#######OOOOOOOOOOOOOOOOOO#
OOOOOOOOOOOOOOOOOOO####OOOOOO##OOOOOOOOOOOOOOOOOO#
OOOOOOOOOOOOOOOOOOO####OOOOO###OOOOOOOOOOOOOOOOOO#
OOOOOOOOOOOOOOOOOOO##OOOOOOOOO#OOOOOOOOOOOOOOOOOO#
OOOOOOOOOOOOOOOOOOO#OOOOOONOOO###########OOOOOOOO#
OOOOOOOOOOOOOOOOOOO##OOOOOOOO############OOOOOOOO#
OOOOOOOOOOOOOOOOOOO#OOOOOOOOOO###########OOOOOOOO#
OOOOOOOOOOOOOOOOOOO#OOOOOOO###OOOOOOOO###OOOOOOOO#
OOOOOOOOOOOOOOOOOOO#OOOOOO#OOOOOOOOOO####OOOOOOOO#
OOOOOOOOOOOOOOOOOOO###OOOOOOOOOOOOOOOOOO#OOOOOOOO#
OOOOOOOOOOOOOOOOOOO###OOOOOOOOOOOOOOOOOO#OOOOOOOO#
OOOOOOOOOOOOOOOOOOO#OOOOOOOOOOOOOOOOOOOO#OOOOOOOO#
OOOOOOOOOOOOOOOOOOO################OO####OOOOOOOO#
OOOOOOOOOOOOOOOOOOOOOOOOOOOOOOOOOO#OOOOO#OOOOOOOO#
OOOOOOOOOOOOOOOOOOOOOOOOOOOOOOOOOO#OOOOO#OOOOOOOO#
OOOOOOOOOOOOOOOOOOOOOOOOOOOOOOOOOO#OOOOO#OOOOOOOO#
OOOOOOOOOOOOOOOOOOOOOOOOOOOOOOOOOO#######OOOOOOOO#
OOOOOOOOOOOOOOOOOOOOOOOOOOOOOOOOOOOOOOOOOOOOOOOOO#
OOOOOOOOOOOOOOOOOOOOOOOOOOOOOOOOOOOOOOOOOOOOOOOOO#
OOOOOOOOOOOOOOOOOOOOOOOOOOOOOOOOOOOOOOOOOOOOOOOOO#
OOOOOOOOOOOOOOOOOOOOOOOOOOOOOOOOOOOOOOOOOOOOOOOOO#
OOOOOOOOOOOOOOOOOOOOOOOOOOOOOOOOOOOOOOOOOOOOOOOOO#
OOOOOOOOOOOOOOOOOOOOOOOOOOOOOOOOOOOOOOOOOOOOOOOOO#
OOOOOOOOOOOOOOOOOOOOOOOOOOOOOOOOOOOOOOOOOOOOOOOOO#
OOOOOOOOOOOOOOOOOOOOOOOOOOOOOOOOOOOOOOOOOOOOOOOOO#
OOOOOOOOOOOOOOOOOOOOOOOOOOOOOOOOOOOOOOOOOOOOOOOOO#
OOOOOOOOOOOOOOOOOOOOOOOOOOOOOOOOOOOOOOOOOOOOOOOOO#
OOOOOOOOOOOOOOOOOOOOOOOOOOOOOOOOOOOOOOOOOOOOOOOOO#
OOOOOOOOOOOOOOOOOOOOOOOOOOOOOOOOOOOOOOOOOOOOOOOOO#
OOOOOOOOOOOOOOOOOOOOOOOOOOOOOOOOOOOOOOOOOOOOOOOOO#
OOOOOOOOOOOOOOOOOOOOOOOOOOOOOOOOOOOOOOOOOOOOOOOOO#
