OOOOOOOOOOOOOOOOOOOOOOOOOOOOOOOOOOOOOOOOOOOOOOOOO#
OOOOOOOOOOOOOOOOOOOOOOOOOOOOOOOOOOOOOOOOOOOOOOOOO#
OOOOOOOOOOOOOOOOOOOOOOOOOOOOOOOOOOOOOOOOOOOOOOOOO#
OOOOOOOOOOOOOOOOOOOOOOOOOOOOOOOOOOOOOOOOOOOOOOOOO#
OOOOOOOOOOOOOOOOOOOOOOOOOOOOOOOOOOOOOOOOOOOOOOOOO#
OOOOOOOOOOOOOOOOOOOOOOOOOOOOOOOOOOOOOOOOOOOOOOOOO#
OOOOOOOOOOOOOOOOOOOOOOOOOOOOOOOOOOOOOOOOOOOOOOOOO#
OOOOOOOOOOOOOOOOOOOOOOOOOOOOOOOOOOOOOOOOOOOOOOOOO#
OOOOOOOOOOOOOOOOOOOOOOOOOOOOOOOOOOOOOOOOOOOOOOOOO#
OOOOOOOOOOOOOOOOOOOOOOOOOOOOOOOOOOOOOOOOOOOOOOOOO#
OOOOOOOOOOOOOOOOOOOOOOOOOOOOOOOOOOOOOOOOOOOOOOOOO#
OOOOOOOOOOOOOOOOOOO############OOOOOOOOOOOOOOOOOO#
OOOOOOOOOOOOOOOOOOO########D###OOOOOOOOOOOOOOOOOO#
OOOOOOOOOOOOOOOOOOO########O###OOOOOOOOOOOOOOOOOO#
OOOOOOOOOOOOOOOOOOO#OOOOOOOOOO#OOOOOOOOOOOOOOOOOO#
OOOOOOOOOOOOOOOOOOO#OOOEOOOOOO#OOOOOOOOOOOOOOOOOO#
OOOOOOOOOOOOOOOOOOO#OOOOOOOOOO#OOOOOOOOOOOOOOOOOO#
OOOOOOOOOOO#########OOOO##OOOO#OOOOOOOOOOOOOOOOOO#
OOOOOOOOOOO#########OOOO##OOOO#OOOOOOOOOOOOOOOOOO#
OOOOO###############OOOO##OOOO#OOOOOOOOOOOOOOOOOO#
OOOOO###D###OOOOOOOOOOOO##OOOO#OOOOOOOOOOOOOOOOOO#
OOOOO###O###OOOOOOOOOOOOOOOEOO#OOOOOOOOOOOOOOOOOO#
OOOOO#OOOOOOOOOOOOOOOOOOOOOOOO#OOOOOOOOOOOOOOOOOO#
OOOOO#OOOOOOOOOOOOOOONOOO##OOO#OOOOOOOOOOOOOOOOOO#
OOOOO#OOOOOOOOO##OOOOOOOO##OOO#OOOOOOOOOOOOOOOOOO#
OOOOO#OOOEOOOOO##OOOOOOOO##OOO#OOOOOOOOOOOOOOOOOO#
OOOOO#OOOOOOOOO##OOOOOOOO##OOO#OOOOOOOOOOOOOOOOOO#
OOOOO#OOOOOOOOO##OOOOOOOOOOOOO#OOOOOOOOOOOOOOOOOO#
OOOOO#OOOOOOOOOOOOOOOOOEOOOOOO#OOOOOOOOOOOOOOOOOO#
OOOOO#######OOOOOOOOOOOOOOOOOO#OOOOOOOOOOOOOOOOOO#
OOOOOOOOOOO#OOOOOO##OOOOOOOOOO#OOOOOOOOOOOOOOOOOO#
OOOOOOOOOOO#OOOOOO##OOOO##OOOO#OOOOOOOOOOOOOOOOOO#
OOOOOOOOOOO#OOOOOO##OOOO##OOOO#OOOOOOOOOOOOOOOOOO#
OOOOOOOOOOO#OOOOOO##OOOO##OOOO#OOOOOOOOOOOOOOOOOO#
OOOOOOOOOOO#OOOOOO##OOOO##OEOO#OOOOOOOOOOOOOOOOOO#
OOOOOOOOOOO#OEOOOOOOOOOOOOOOOO#OOOOOOOOOOOOOOOOOO#
OOOOOOOOOOO#OOOOOOOOOOOOOOOOOO#OOOOOOOOOOOOOOOOOO#
OOOOOOOOOOO############D#######OOOOOOOOOOOOOOOOOO#
OOOOOOOOOOOOOOOOOOOOOO###OOOOOOOOOOOOOOOOOOOOOOOO#
OOOOOOOOOOOOOOOOOOOOOOOOOOOOOOOOOOOOOOOOOOOOOOOOO#
OOOOOOOOOOOOOOOOOOOOOOOOOOOOOOOOOOOOOOOOOOOOOOOOO#
OOOOOOOOOOOOOOOOOOOOOOOOOOOOOOOOOOOOOOOOOOOOOOOOO#
OOOOOOOOOOOOOOOOOOOOOOOOOOOOOOOOOOOOOOOOOOOOOOOOO#
OOOOOOOOOOOOOOOOOOOOOOOOOOOOOOOOOOOOOOOOOOOOOOOOO#
OOOOOOOOOOOOOOOOOOOOOOOOOOOOOOOOOOOOOOOOOOOOOOOOO#
OOOOOOOOOOOOOOOOOOOOOOOOOOOOOOOOOOOOOOOOOOOOOOOOO#
OOOOOOOOOOOOOOOOOOOOOOOOOOOOOOOOOOOOOOOOOOOOOOOOO#
OOOOOOOOOOOOOOOOOOOOOOOOOOOOOOOOOOOOOOOOOOOOOOOOO#
OOOOOOOOOOOOOOOOOOOOOOOOOOOOOOOOOOOOOOOOOOOOOOOOO#
OOOOOOOOOOOOOOOOOOOOOOOOOOOOOOOOOOOOOOOOOOOOOOOOO#
