OOOOOOOOOOOOOOOOOOOOOOOOOOOOOOOOOOOOOOOOOOOOOOOOOO
OOOOOOOOOOOOOOOO###################OOOOOOOOOOOOOOO
OOOOOOOOOOOOOOO####################OOOOOOOOOOOOOOO
OOOOOOOOOOOOOOO#####D##############OOOOOOOOOOOOOOO
OOOOOOOOOOOOOOO#####O##############OOOOOOOOOOOOOOO
OOOOOOOOOOOOOOO#####OOOOOOO###OO###OOOOOOOOOOOOOOO
OOOOOOOOOOOOOOO#####OOOOOOOOOOOO###OOOOOOOOOOOOOOO
OOOOOOOOOOOOOOO###OOOOOOOOOOOOOO###OOOOOOOOOOOOOOO
OOOOOOOOOOOOOOO###OOOOOOOONOOOOO###OOOOOOOOOOOOOOO
OOOOOOOOOOOOOOO###OOOOOOOOOOOOOO###OOOOOOOOOOOOOOO
OOOOOOOOOOOOOOO####OOOOOOOOOOOO####OOOOOOOOOOOOOOO
OOOOOOOOOOOOOOO#########OO#########OOOOOOOOOOOOOOO
OOOOOOOOOOOOOOO#########OO#########OOOOOOOOOOOOOOO
OOOOOOOOOOOOOOO#########OO#########OOOOOOOOOOOOOOO
OOOOOOOOOOOOOOO#########OO#########OOOOOOOOOOOOOOO
OOOOOOOOOOOOOOO########OOOO########OOOOOOOOOOOOOOO
OOOOOOOOOOOOOOO######OOOOOOOO######OOOOOOOOOOOOOOO
OOOOOOOOOOOOOOO####OOOOOOOOOOOO####OOOOOOOOOOOOOOO
OOOOOOOOOOOOOOO####OOOOEOEOOOOO####OOOOOOOOOOOOOOO
OOOOOOOOOOOOOOO###OOOOEOOOOEOOOO###OOOOOOOOOOOOOOO
OOOOOOOOOOOOOOO###OOOEOOOOOOEOOO###OOOOOOOOOOOOOOO
OOOOOOOOOOOOOOO##OOOOEOOOOOOOOOOO##OOOOOOOOOOOOOOO
OOOOOOOOOOOOOOO##OOOEOOOOOOOEOOOO##OOOOOOOOOOOOOOO
OOOOOOOOOOOOOOO##OOOOOOOOOOOOOOOO##OOOOOOOOOOOOOOO
OOOOOOOOOOOOOOO##OOOEOOOEOOOEOOOO##OOOOOOOOOOOOOOO
OOOOOOOOOOOOOOO###OOEOOOOOOOOOOO###OOOOOOOOOOOOOOO
OOOOOOOOOOOOOOO###OOOOEOOOOOEOOO###OOOOOOOOOOOOOOO
OOOOOOOOOOOOOOO####OOOEOOOEOOOO####OOOOOOOOOOOOOOO
OOOOOOOOOOOOOOO####OOOOOOEOOOOO####OOOOOOOOOOOOOOO
OOOOOOOOOOOOOOO######OOOOOOOO######OOOOOOOOOOOOOOO
OOOOOOOOOOOOOOO########OOOO########OOOOOOOOOOOOOOO
OOOOOOOOOOOOOOO#########OO#########OOOOOOOOOOOOOOO
OOOOOOOOOOOOOOO#########OO#########OOOOOOOOOOOOOOO
OOOOOOOOOOOOOOO#########OO#########OOOOOOOOOOOOOOO
OOOOOOOOOOOOOOO#########OO#########OOOOOOOOOOOOOOO
OOOOOOOOOOOOOOO####OO##OOOOO##O####OOOOOOOOOOOOOOO
OOOOOOOOOOOOOOO###OOOOOOOOOOOOOO###OOOOOOOOOOOOOOO
OOOOOOOOOOOOOOO###OOOOOOOOOOOOOO###OOOOOOOOOOOOOOO
OOOOOOOOOOOOOOO###OOOOOO##OOOOOO###OOOOOOOOOOOOOOO
OOOOOOOOOOOOOOO###OOOOOO##OOOOOO###OOOOOOOOOOOOOOO
OOOOOOOOOOOOOOO###OOOOOO##OOOOOO###OOOOOOOOOOOOOOO
OOOOOOOOOOOOOOO#####D########D#####OOOOOOOOOOOOOOO
OOOOOOOOOOOOOOO####################OOOOOOOOOOOOOOO
OOOOOOOOOOOOOOO####################OOOOOOOOOOOOOOO
OOOOOOOOOOOOOOO####################OOOOOOOOOOOOOOO
OOOOOOOOOOOOOOOOOOOOOOOOOOOOOOOOOOOOOOOOOOOOOOOOOO
OOOOOOOOOOOOOOOOOOOOOOOOOOOOOOOOOOOOOOOOOOOOOOOOOO
OOOOOOOOOOOOOOOOOOOOOOOOOOOOOOOOOOOOOOOOOOOOOOOOOO
OOOOOOOOOOOOOOOOOOOOOOOOOOOOOOOOOOOOOOOOOOOOOOOOOO
OOOOOOOOOOOOOOOOOOOOOOOOOOOOOOOOOOOOOOOOOOOOOOOOOO
