OOOOOOOOOOOOOOOOOOOOOOOOOOOOOOOOOOOOOOOOOOOOOOOOO#
OOOOOOOOOOOOOOOOOOOOOOOOOOOOOOOOOOOOOOOOOOOOOOOOO#
OOOOOOOOOOOOOOOOOOOOOOOOOOOOOOOOOOOOOOOOOOOOOOOOO#
OOOOOOOOOOOOOOOOOOOOOOOOOOOOOOOOOOOOOOOOOOOOOOOOO#
OOOOOOOOOOOOOOOOOOOOOOOOOOOOOOOOOOOOOOOOOOOOOOOOO#
OOOOOOOOOOOOOOOOOOOOOOOOOOOOOOOOOOOOOOOOOOOOOOOOO#
OOOOOOOOOOOOOOOOOOOOOOOOOOOOOOOOOOOOOOOOOOOOOOOOO#
OOOOOOOOOOOOOOOOOOOOOOOOOOOOOOOOOOOOOOOOOOOOOOOOO#
OOOOOOOOOOOOOOOOOOOOOOOOOOOOOOOOOOOOOOOOOOOOOOOOO#
OOOOOOOOOOOOOOOOOOOOOOOOOOOOOOOOOOOOOOOOOOOOOOOOO#
OOOOOOOOOOOOOOOOOOOOOOOOOOOOOOOOOOOOOOOOOOOOOOOOO#
OOOOOOOOOOOOOOOOOOOOOOOOOOOOOOOOOOOOOOOOOOOOOOOOO#
OOOOOOOOOOOOOOOOOOOOOOOOOOOOOOOOOOOOOOOOOOOOOOOOO#
OOOOOOOOOOOO###OOOOOOOOOOOOOOOOOOOOOOOOOOOOOOOOOO#
OOOOOOOOOOOO#D#OOOOOOOOOOOOOOOOOOOOOOOOOOOOOOOOOO#
OOOOOOOO#####O###OOOOOOOOOOOOOOOOOOOOOOOOOOOOOOOO#
OOOOOOOO#OOOOOOO#OOOOOOOOOOOOOOOOOOOOOOOOOOOOOOOO#
OOOOOOOO#OOEOOOO#OOOOOOOOOOOOOOOOOOOOOOOOOOOOOOOO#
OOOOOOOO#OOOOOOO#OOOOOOOOOOOOOOOOOOOOOOOOOOOOOOOO#
OOOOOOOO#OOOOOOO#######################OOOOOOOOOO#
OOOOOOOO#OOOOOOOOOOOOOOOOOOOOOOOOO###O#OOOOOOOOOO#
OOOOOOOO#OOOOEOOOOOOEOOOOOOOOOOOOO###O#OOOOOOOOOO#
OOOOOOOO#OOOOOOOOOOOOOOOOOOOOEOOOOOOOO#OOOOOOOOOO#
OOOOOOOO#OOOOOOOOOOOOOOOOOOOOOOOOOOOOO#OOOOOOOOOO#
OOOOOOOO#OOOOOO########OO##############OOOOOOOOOO#
OOOOOOOO#OOOOOO########OO##############OOOOOOOOOO#
OOOOOOOO#OOOEOO########OO##############OOOOOOOOOO#
OOOOOOOO#OOOOOO########OO##############OOOOOOOOOO#
OOOOOOOO##OOOOO########OO##############OOOOOOOOOO#
OOOOOOOO##OOOOO########OO##############OOOOOOOOOO#
OOOOOOOO#OOOOOO####OOOOOOOOOOOOOOOOOOO#OOOOOOOOOO#
OOOOOOOO#OOOOOO####OOOOOEOOOOOOOOOOOOO#OOOOOOOOOO#
OOOOOOOO#OOOEOO####OOOOOOOOOOOOOOEOOOO#OOOOOOOOOO#
OOOOOOOO#OOOOOO####OOOOOOOOOOOOOOOOOOO#OOOOOOOOOO#
OOOOOOOO########################OOOO###OOOOOOOOOO#
OOOOOOOOOOOOOOOOOOOOOOOOOOOOOOO#OOOO###OOOOOOOOOO#
OOOOOOOOOOOOOOOOOOOOOOOOOOOOOOO###OOOO#OOOOOOOOOO#
OOOOOOOOOOOOOOOOOOOOOOOOOOOOOOO###OO###OOOOOOOOOO#
OOOOOOOOOOOOOOOOOOOOOOOOOOOOOOO#OOOO###OOOOOOOOOO#
OOOOOOOOOOOOOOOOOOOOOOOOOOOOOOO#OOOOOO#OOOOOOOOOO#
OOOOOOOOOOOOOOOOOOOOOOOOOOOOOOO#OOOOOO#OOOOOOOOOO#
OOOOOOOOOOOOOOOOOOOOOOOOOOOOOOO####D###OOOOOOOOOO#
OOOOOOOOOOOOOOOOOOOOOOOOOOOOOOOOOO###OOOOOOOOOOOO#
OOOOOOOOOOOOOOOOOOOOOOOOOOOOOOOOOOOOOOOOOOOOOOOOO#
OOOOOOOOOOOOOOOOOOOOOOOOOOOOOOOOOOOOOOOOOOOOOOOOO#
OOOOOOOOOOOOOOOOOOOOOOOOOOOOOOOOOOOOOOOOOOOOOOOOO#
OOOOOOOOOOOOOOOOOOOOOOOOOOOOOOOOOOOOOOOOOOOOOOOOO#
OOOOOOOOOOOOOOOOOOOOOOOOOOOOOOOOOOOOOOOOOOOOOOOOO#
OOOOOOOOOOOOOOOOOOOOOOOOOOOOOOOOOOOOOOOOOOOOOOOOO#
OOOOOOOOOOOOOOOOOOOOOOOOOOOOOOOOOOOOOOOOOOOOOOOOO#
