OOOOOOOOOOOOOOOOOOOOOOOOOOOOOOOOOOOOOOOOOOOOOOOOO#
OOOOOOOOOOOOOOOOOOOOOOOOOOOOOOOOOOOOOOOOOOOOOOOOO#
OOOOOOOOOOOOOOOOOOOOOOOOOOOOOOOOOOOOOOOOOOOOOOOOO#
OOOOOOOOOOOOOOOOOOOOOOOOOOOOOOOOOOOOOOOOOOOOOOOOO#
OOOOOOOOOOOOOOOOOOOOOOOOOOOOOOOOOOOOOOOOOOOOOOOOO#
OOOOOOOOOOOOOOOOOOOOOOOOOOOOOOOOOOOOOOOOOOOOOOOOO#
OOOOOOOOOOOOOOOOOOOOOOOOOOOOOOOOOOOOOOOOOOOOOOOOO#
OOOOOOOOOOOOOOOOOOOOOOOOOOOOOOOOOOOOOOOOOOOOOOOOO#
OOOOOOOOOOOOOOOOOOOOOOOOOOOOOOOOOOOOOOOOOOOOOOOOO#
OOOOOOOOOOOOOOOOOOOOOOOOOOOOOOOOOOOOOOOOOOOOOOOOO#
OOOOOOOOOOOOOOOOOOOOOOOOOOOOOOOOOOOOOOOOOOOOOOOOO#
OOOOOOOOOOOOOOOOOOOOOOOOOOOOOOOOOOOOOOOOOOOOOOOOO#
OOOOOOOOOOOOO#OOOOOOOOOOOOOOOOOOOOOOOOOOOOOOOOOOO#
OOOOOOOOOOOO###OOOOOOOOOOOOOOOOOOOOOOOOOOOOOOOOOO#
OOOOOOOOOOO##D##OOOOOOOOOOOOOOOOOOOOOOOOOOOOOOOOO#
OOOOOOOO#####O###OOOOOOOOOOOOOOOOOOOOOOOOOOOOOOOO#
OOOOOOOO#OOOOOOO#OOOOOOOOOOOOOOOOOOOOOOOOOOOOOOOO#
OOOOOOOO#OOOOOOO#OOOOOOOOOOOOOOOOOOOOOOOOOOOOOOOO#
OOOOOOOO#OOEOOOO#OOOOOOOOOOOOOOOOOOOOOOOOOOOOOOOO#
OOOOOOOO#OOOOOOO#######################OOOOOOOOOO#
OOOOOOOO#OOOOOOOOOOOOOOOOOOOOOOOOO###O#OOOOOOOOOO#
OOOOOOOO#OOOOOOOEOOOOOOOOOOOOOOOOO###O#OOOOOOOOOO#
OOOOOOOO#OOOOOOOOOOOOOOOOOOOOEOOOOOOOO#OOOOOOOOOO#
OOOOOOOO#OOEOOOOOOOOOOOOOOOOOOOOOOOOOO#OOOOOOOOOO#
OOOOOOOO#OOOOOO########OO##############OOOOOOOOOO#
OOOOOOOO#OOOOOO#OOOOOO#OO#OOOOOOOOOOOOOOOOOOOOOOO#
OOOOOOOO#OOOOOO#OOOOOO#OO#OOOOOOOOOOOOOOOOOOOOOOO#
OOOOOOOO#OOOEOO#OOOOOO#OO#OOOOOOOOOOOOOOOOOOOOOOO#
OOOOOOOO##OOOOO#OOOOOO#OO#OOOOOOOOOOOOOOOOOOOOOOO#
OOOOOOOO##OOOOO#OO#####OO##############OOOOOOOOOO#
OOOOOOOO#OOOOOO#OO#OOOOOOOOOOOOOOOOOOO#OOOOOOOOOO#
OOOOOOOO#OONOOO#OO#OOOOOOOEOOOOOOOOOOO#OOOOOOOOOO#
OOOOOOOO#OOOEOO#OO#OOEOOOOOOOOOEOOOOOO#OOOOOOOOOO#
OOOOOOOO#OOOOOO#OO#OOOOOOOOOOOOOOOOOOO#OOOOOOOOOO#
OOOOOOOO########OO##############OOOO###OOOOOOOOOO#
OOOOOOOOOOOOOOOOOOOOOOOOOOOOOOO#OOOO###OOOOOOOOOO#
OOOOOOOOOOOOOOOOOOOOOOOOOOOOOOO###OOOO#OOOOOOOOOO#
OOOOOOOOOOOOOOOOOOOOOOOOOOOOOOO###OO###OOOOOOOOOO#
OOOOOOOOOOOOOOOOOOOOOOOOOOOOOOO#OOOO###OOOOOOOOOO#
OOOOOOOOOOOOOOOOOOOOOOOOOOOOOOO#OOEOOO#OOOOOOOOOO#
OOOOOOOOOOOOOOOOOOOOOOOOOOOOOOO#OOOOOO#OOOOOOOOOO#
OOOOOOOOOOOOOOOOOOOOOOOOOOOOOOO####D###OOOOOOOOOO#
OOOOOOOOOOOOOOOOOOOOOOOOOOOOOOOOO#####OOOOOOOOOOO#
OOOOOOOOOOOOOOOOOOOOOOOOOOOOOOOOOOOOOOOOOOOOOOOOO#
OOOOOOOOOOOOOOOOOOOOOOOOOOOOOOOOOOOOOOOOOOOOOOOOO#
OOOOOOOOOOOOOOOOOOOOOOOOOOOOOOOOOOOOOOOOOOOOOOOOO#
OOOOOOOOOOOOOOOOOOOOOOOOOOOOOOOOOOOOOOOOOOOOOOOOO#
OOOOOOOOOOOOOOOOOOOOOOOOOOOOOOOOOOOOOOOOOOOOOOOOO#
OOOOOOOOOOOOOOOOOOOOOOOOOOOOOOOOOOOOOOOOOOOOOOOOO#
OOOOOOOOOOOOOOOOOOOOOOOOOOOOOOOOOOOOOOOOOOOOOOOOO#
