OOOOOOOOOOOOOOOOOOOOOOOOOOOOOOOOOOOOOOOOOOOOOOOOO#
OOOOOOOOOOOOOOOOOOOOOOOOOOOOOOOOOOOOOOOOOOOOOOOOO#
OOOOOOOOOOOOOOOOOOOOOOOOOOOOOOOOOOOOOOOOOOOOOOOOO#
OOOOOOOOOOOOOOOOOOOOOOOOOOOOOOOOOOOOOOOOOOOOOOOOO#
OOOOOOOOOOOOOOOOOOOOOOOOOOOOOOOOOOOOOOOOOOOOOOOOO#
OOOOOOOOOOOOOOOOOOOOOOOOOOOOOOOOOOOOOOOOOOOOOOOOO#
OOOOOOOOOOOOOOOOOOOOOOOOOOOOOOOOOOOOOOOOOOOOOOOOO#
OOOOOOOOOOOOOOOOOOOOOOOOOOOOOOOOOOOOOOOOOOOOOOOOO#
OOOOOOOOOOOOOOOOOOOOOOOOOOOOOOOOOOOOOOOOOOOOOOOOO#
OOOOOOOOOOOOOOOOOOOOOOOOOOOOOOOOOOOOOOOOOOOOOOOOO#
OOOOOOOOOOOOOOOOOOOOOOOOOOOOOOOOOOOOOOOOOOOOOOOOO#
OOOOOOOOOOOOOOOOOOOOOOOOOOOOOOOOOOOOOOOOOOOOOOOOO#
OOOOOOOOOOOOOOOOOOOOOOOOOOOOOOOOOOOOOOOOOOOOOOOOO#
OOOOOOOOOOOOOOOOOOOOOOOOOOOOOOOOOOOOOOOOOOOOOOOOO#
OOOOOOOOOOOOOOOO#########OOOOOOOOOOOOOOOOOOOOOOOO#
OOOOOOOOOOOOOOOO#########OOOOOOOO######OOOOOOOOOO#
OOOOOOOOOOOOOOOO#########OOOOOOOO##D###OOOOOOOOOO#
OOOOOOOOOOOOOOOO###################O###OOOOOOOOOO#
OOOOOOOOOOOOOOOO#O################OOOO#OOOOOOOOOO#
OOOOOOOOOOOOOOOO####OOOO##########OOOO#OOOOOOOOOO#
OOOOOOOOOOOOOOOO####OEOOOOOOOOOOOOOEOO#OOOOOOOOOO#
OOOOOOOOOOOOOOOO####ONOOOOOOOOOOOOOOOO#OOOOOOOOOO#
OOOOOOOOOOOOOOOO###OOOOEOOO############OOOOOOOOOO#
OOOOOOOOOOOOOOOO#OOOOOOOOOO############OOOOOOOOOO#
OOOOOOOOOOOOOOOO########OOO############OOOOOOOOOO#
OOOOOOOOOOOOOOOOOOOOOO##OOO############OOOOOOOOOO#
OOOOOOOOOOOOOOOOOOOOOOO#OOO############OOOOOOOOOO#
OOOOOOOOOOOOOOOOOOOOOOO#OOOOOOOOOOOOOO#OOOOOOOOOO#
OOOOOOOOOOOOOOOOOOOOOOO#OEOOOOOOOOOOOO#OOOOOOOOOO#
OOOOOOOOOOOOOOOOOOOOOOO#OOO##O##O##O###OOOOOOOOOO#
OOOOOOOOOOOOOOOOOOOOOOO#OOO##O##O##O###OOOOOOOOOO#
OOOOOOOOOOOOOOOOOOOOOOO#OOOOOOOOOOOEOO#OOOOOOOOOO#
OOOOOOOOOOOOOOOOOOOOOOO#OOOOOOOOOOOOOO#OOOOOOOOOO#
OOOOOOOOOOOOOOOOOOOOOOO###D############OOOOOOOOOO#
OOOOOOOOOOOOOOOOOOOOOOOOO###OOOOOOOOOOOOOOOOOOOOO#
OOOOOOOOOOOOOOOOOOOOOOOOOOOOOOOOOOOOOOOOOOOOOOOOO#
OOOOOOOOOOOOOOOOOOOOOOOOOOOOOOOOOOOOOOOOOOOOOOOOO#
OOOOOOOOOOOOOOOOOOOOOOOOOOOOOOOOOOOOOOOOOOOOOOOOO#
OOOOOOOOOOOOOOOOOOOOOOOOOOOOOOOOOOOOOOOOOOOOOOOOO#
OOOOOOOOOOOOOOOOOOOOOOOOOOOOOOOOOOOOOOOOOOOOOOOOO#
OOOOOOOOOOOOOOOOOOOOOOOOOOOOOOOOOOOOOOOOOOOOOOOOO#
OOOOOOOOOOOOOOOOOOOOOOOOOOOOOOOOOOOOOOOOOOOOOOOOO#
OOOOOOOOOOOOOOOOOOOOOOOOOOOOOOOOOOOOOOOOOOOOOOOOO#
OOOOOOOOOOOOOOOOOOOOOOOOOOOOOOOOOOOOOOOOOOOOOOOOO#
OOOOOOOOOOOOOOOOOOOOOOOOOOOOOOOOOOOOOOOOOOOOOOOOO#
OOOOOOOOOOOOOOOOOOOOOOOOOOOOOOOOOOOOOOOOOOOOOOOOO#
OOOOOOOOOOOOOOOOOOOOOOOOOOOOOOOOOOOOOOOOOOOOOOOOO#
OOOOOOOOOOOOOOOOOOOOOOOOOOOOOOOOOOOOOOOOOOOOOOOOO#
OOOOOOOOOOOOOOOOOOOOOOOOOOOOOOOOOOOOOOOOOOOOOOOOO#
OOOOOOOOOOOOOOOOOOOOOOOOOOOOOOOOOOOOOOOOOOOOOOOOO#
