OOOOOOOOOOOOOOOOOOOOOOOOOOOOOOOOOOOOOOOOOOOOOOOOO#
OOOOOOOOOOOOOOOOOOOOOOOOOOOOOOOOOOOOOOOOOOOOOOOOO#
OOOOOOOOOOOOOOOOOOOOOOOOOOOOOOOOOOOOOOOOOOOOOOOOO#
OOOOOOOOOOOOOOOOOOOOOOOOOOOOOOOOOOOOOOOOOOOOOOOOO#
OOOOOOOOOOOOOOOOOOOOOOOOOOOOOOOOOOOOOOOOOOOOOOOOO#
OOOOOOOOOOOOOOOOOOOOOOOOOOOOOOOOOOOOOOOOOOOOOOOOO#
OOOOOOOOOOOOOOOOOOOOOOOOOOOOOOOOOOOOOOOOOOOOOOOOO#
OOOOOOOOOOOOOOOOOOO##############OOOOOOOOOOOOOOOO#
OOOOOOOOOOOOOOOOOOO##############OOOOOOOOOOOOOOOO#
OOOOOOOOOOOOOOOOOOO##############OOOOOOOOOOOOOOOO#
OOOOOOOOOOOOOOOOOOO#O####OOOOOOO##OOOOOOOOOOOOOOO#
OOOOOOOOOOOOOOOOOOO#OOO#OOOEOOOOD#OOOOOOOOOOOOOOO#
OOOOOOOOOOOOOOOOOOO#OOOOOOOOOOOO##OOOOOOOOOOOOOOO#
OOOOOOOOOOOOOOOOOOO#OOOOOOOOOOOO#OOOOOOOOOOOOOOOO#
OOOOOOOOOOOOOOOOOO##OOEOOOOOOOOO#OOOOOOOOOOOOOOOO#
OOOOOOOOOOOOOOOOOO#OOOOOOOO######OOOOOOOOOOOOOOOO#
OOOOOOOOOOOOOOOOOO#OOOOOOOO#OOOOOOOOOOOOOOOOOOOOO#
OOOOOOOOOOOOOOOOOO#OOOOOOOO#OOOOOOOOOOOOOOOOOOOOO#
OOOOOOOOOOOOOOOOOO#OOONOEOO#OOOOOOOOOOOOOOOOOOOOO#
OOOOOOOOOOOOOOOOOO#OOOOOOOO#OOOOOOOOOOOOOOOOOOOOO#
OOOOOOOOOOOOOOOOOO####OO####OOOOOOOOOOOOOOOOOOOOO#
OOOOOOOOOOOOOOOOOOOOO#OO#OOOOOOOOOOOOOOOOOOOOOOOO#
OOOOOOOOOOOOOOOOOOOOO#OO#OOOOOOOOOOOOOOOOOOOOOOOO#
OOOOOOOOOOOOOOOOOOOOO#OO#OOOOOOOOOOOOOOOOOOOOOOOO#
OOOOOOOOOOOOOOOOOOO###OO###OOOOOOOOOOOOOOOOOOOOOO#
OOOOOOOOOOOOOOOOOOO#OOOOOO#OOOOOOOOOOOOOOOOOOOOOO#
OOOOOOOOOOOOOOOOOOO#OOOOOO#OOOOOOOOOOOOOOOOOOOOOO#
OOOOOOOOOOOOO#######OOEOOO#OOOOOOOOOOOOOOOOOOOOOO#
OOOOOOOOOOOOO#######OOOOOO#OOOOOOOOOOOOOOOOOOOOOO#
OOOOOOOOOOOOO#######OOOOOO#OOOOOOOOOOOOOOOOOOOOOO#
OOOOOOOOOOOOO#OOOOOOOOOOOO#OOOOOOOOOOOOOOOOOOOOOO#
OOOOOOOOOOOOO#OOOOOOOOOOOO#OOOOOOOOOOOOOOOOOOOOOO#
OOOOOOOOOOOO##OOOOOOEOOO###OOOOOOOOOOOOOOOOOOOOOO#
OOOOOOOOOOOO#DOOOOOOOOOO###OOOOOOOOOOOOOOOOOOOOOO#
OOOOOOOOOOOO##OOOOOOOOO####OOOOOOOOOOOOOOOOOOOOOO#
OOOOOOOOOOOOO##############OOOOOOOOOOOOOOOOOOOOOO#
OOOOOOOOOOOOOOOOOOOOOOOOOOOOOOOOOOOOOOOOOOOOOOOOO#
OOOOOOOOOOOOOOOOOOOOOOOOOOOOOOOOOOOOOOOOOOOOOOOOO#
OOOOOOOOOOOOOOOOOOOOOOOOOOOOOOOOOOOOOOOOOOOOOOOOO#
OOOOOOOOOOOOOOOOOOOOOOOOOOOOOOOOOOOOOOOOOOOOOOOOO#
OOOOOOOOOOOOOOOOOOOOOOOOOOOOOOOOOOOOOOOOOOOOOOOOO#
OOOOOOOOOOOOOOOOOOOOOOOOOOOOOOOOOOOOOOOOOOOOOOOOO#
OOOOOOOOOOOOOOOOOOOOOOOOOOOOOOOOOOOOOOOOOOOOOOOOO#
OOOOOOOOOOOOOOOOOOOOOOOOOOOOOOOOOOOOOOOOOOOOOOOOO#
OOOOOOOOOOOOOOOOOOOOOOOOOOOOOOOOOOOOOOOOOOOOOOOOO#
OOOOOOOOOOOOOOOOOOOOOOOOOOOOOOOOOOOOOOOOOOOOOOOOO#
OOOOOOOOOOOOOOOOOOOOOOOOOOOOOOOOOOOOOOOOOOOOOOOOO#
OOOOOOOOOOOOOOOOOOOOOOOOOOOOOOOOOOOOOOOOOOOOOOOOO#
OOOOOOOOOOOOOOOOOOOOOOOOOOOOOOOOOOOOOOOOOOOOOOOOO#
OOOOOOOOOOOOOOOOOOOOOOOOOOOOOOOOOOOOOOOOOOOOOOOOO#
