OOOOOOOOOOOOOOOOOOOOOOOOOOOOOOOOOOOOOOOOOOOOOOOOO#
OOOOOOOOOOOOOOOOOOOOOOOOOOOOOOOOOOOOOOOOOOOOOOOOO#
OOOOOOOOOOOOOOOOOOOOOOOOOOOOOOOOOOOOOOOOOOOOOOOOO#
OOOOOOOOOOOOOOOOOOOOOOOOOOOOOOOOOOOOOOOOOOOOOOOOO#
OOOOOOOOOOOOOOOOOOOOOOOOOOOOOOOOOOOOOOOOOOOOOOOOO#
OOOOOOOOOOOOOOOOOOOOOOOOOOOOOOOOOOOOOOOOOOOOOOOOO#
OOOOOOOOOOOOOOOOOOOOOOOOOOOOOOOOOOOOOOOOOOOOOOOOO#
OOOOOOOOOOOOOOOOOOOOOOOOOOOOOOOOOOOOOOOOOOOOOOOOO#
OOOOOOOOOOOOOOOOOOOOOOOOOOOOOOOOOOOOOOOOOOOOOOOOO#
OOOOOOOOOOOOOOOOOOOOOOOOOOOOOOOOOOOOOOOOOOOOOOOOO#
OOOOOOOOOOOOOOOOOOOOOOOOOOOOOOOOOOOOOOOOOOOOOOOOO#
OOOOOOOOOOOOOOOOOOOOOOOOOOOOOOOOOOOOOOOOOOOOOOOOO#
OOOOOOOOOOOOOOOOOOOOOOOOOOOOOOOOOOOOOOOOOOOOOOOOO#
OOOOOOOOOOOOOOOOOOOOOOOOOOOOOOOOOOOOOOOOOOOOOOOOO#
OOOOOOOOOOOOOOOOOO########OOOOOOOOOOOOOOOOOOOOOOO#
OOOOOOOOOOOOOOOOOO########OOOOOOOOOOOOOOOOOOOOOOO#
OOOOOOOOOOOOOOOOOO########OOOOOOOOOOOOOOOOOOOOOOO#
OOOOOOOOOOOO############O#######OOOOOOOOOOOOOOOOO#
OOOOOOOOOOOO###D###OOO##########OOOOOOOOOOOOOOOOO#
OOOOOOOOOOOO###O###OOOO#########OOOOOOOOOOOOOOOOO#
OOOOOOOOOOOO#OOOO#OOEOOOOO######OOOOOOOOOOOOOOOOO#
OOOOOOOOOOOO#OOOOOOOOOOOOOOOOO##OOOOOOOOOOOOOOOOO#
OOOOOOOOOOOO#OOOOOOOOOOOOOOOOOO#OOOOOOOOOOOOOOOOO#
OOOOOOOOOOOO#OOO############OOO#OOOOOOOOOOOOOOOOO#
OOOOOOOOOOOO#OOO############OOO#OOOOOOOOOOOOOOOOO#
OOOOOOOOOOOO#OOO############OOO#OOOOOOOOOOOOOOOOO#
OOOOOOOOOOOO#OOO############OOO#OOOOOOOOOOOOOOOOO#
OOOOOOOOOOOO#OOO####OOOO####OOO#OOOOOOOOOOOOOOOOO#
OOOOOOOOOOOO#OOOOOOOOOOOOOOOOOO#OOOOOOOOOOOOOOOOO#
OOOOOOOOOOOO#OOOOOOOONEOOOOOOOO#OOOOOOOOOOOOOOOOO#
OOOOOOOOOOOO#OOO####OOOO####OOO#OOOOOOOOOOOOOOOOO#
OOOOOOOOOOOO#OOO############OOO#OOOOOOOOOOOOOOOOO#
OOOOOOOOOOOO#OOO############OOO#OOOOOOOOOOOOOOOOO#
OOOOOOOOOOOO#OOO############OOO#OOOOOOOOOOOOOOOOO#
OOOOOOOOOOOO#OOO############OOO#OOOOOOOOOOOOOOOOO#
OOOOOOOOOOOO#OOOOO########OOOOO#OOOOOOOOOOOOOOOOO#
OOOOOOOOOOOO#OOOOOOOOOOOOOOOOOO#OOOOOOOOOOOOOOOOO#
OOOOOOOOOOOO#OOOOOOOOOOOOOOOOOO#OOOOOOOOOOOOOOOOO#
OOOOOOOOOOOO#######OOOOOO####D##OOOOOOOOOOOOOOOOO#
OOOOOOOOOOOOOOOOOO#OOOEOO#OO###OOOOOOOOOOOOOOOOOO#
OOOOOOOOOOOOOOOOOO#OOOOOO#OOOOOOOOOOOOOOOOOOOOOOO#
OOOOOOOOOOOOOOOOOO########OOOOOOOOOOOOOOOOOOOOOOO#
OOOOOOOOOOOOOOOOOOOOOOOOOOOOOOOOOOOOOOOOOOOOOOOOO#
OOOOOOOOOOOOOOOOOOOOOOOOOOOOOOOOOOOOOOOOOOOOOOOOO#
OOOOOOOOOOOOOOOOOOOOOOOOOOOOOOOOOOOOOOOOOOOOOOOOO#
OOOOOOOOOOOOOOOOOOOOOOOOOOOOOOOOOOOOOOOOOOOOOOOOO#
OOOOOOOOOOOOOOOOOOOOOOOOOOOOOOOOOOOOOOOOOOOOOOOOO#
OOOOOOOOOOOOOOOOOOOOOOOOOOOOOOOOOOOOOOOOOOOOOOOOO#
OOOOOOOOOOOOOOOOOOOOOOOOOOOOOOOOOOOOOOOOOOOOOOOOO#
OOOOOOOOOOOOOOOOOOOOOOOOOOOOOOOOOOOOOOOOOOOOOOOOO#
