OOOOOOOOOOOOOOOOOOOOOOOOOOOOOOOOOOOOOOOOOOOOOOOOO#
OOOOOOOOOOOOOOOOOOOOOOOOOOOOOOOOOOOOOOOOOOOOOOOOO#
OOOOOOOOOOOOOOOOOOOOOOOOOOOOOOOOOOOOOOOOOOOOOOOOO#
OOOOOOOOOOOOOOOOOOOOOOOOOOOOOOOOOOOOOOOOOOOOOOOOO#
OOOOOOOOOOOOOOOOOOOOOOOOOOOOOOOOOOOOOOOOOOOOOOOOO#
OOOOOOOOOOOOOOOOOOOOOOOOOOOOOOOOOOOOOOOOOOOOOOOOO#
OOOOOOOOOOOOOOOOOOOOOOOOOOOOOOOOOOOOOOOOOOOOOOOOO#
OOOOOOOOOOOOOOOOOOOOOOOOOOOOOOOOOOOOOOOOOOOOOOOOO#
OOOOOOOOOOOOOOOOO########OOOO###########OOOOOOOOO#
OOOOOOOOOOOOOOOOO###D####OOOO###########OOOOOOOOO#
OOOOOOOOOOOOOOOOO###O####OOOO###########OOOOOOOOO#
OOOOOOOOOOOOOOOOO#OOO#########OOOO##OO##OOOOOOOOO#
OOOOOOOOOOOOOOOOO#OOOOOO######OOEOOOOOO#OOOOOOOOO#
OOOOOOOOOOOOOOOOO#OOOOOO######OOOOONOOO#OOOOOOOOO#
OOOOOOOOOOOOOOOOO#OOOOOOOO####OOOO###OO#OOOOOOOOO#
OOOOOOOOOOOOOOOOO#OOOOEOOOOOOOOOOO###OO#OOOOOOOOO#
OOOOOOOOOOOOOOOOO#OOOOOOOOOOOOOOOO###OO#OOOOOOOOO#
OOOOOOOOOOOOOOOOO#############OOOO###OO#OOOOOOOOO#
OOOOOOOOOOOOOOOOOOOOOOOOOOOOO#OOOO###OO#OOOOOOOOO#
OOOOOOOOOOOOOOOOOOOOOOOOOOOOO#OOEOOOOOO#OOOOOOOOO#
OOOOOOOOOOOOOOOOO###########O#OOOOOOOOO#OOOOOOOOO#
OOOOOOOOOOOOOOOOO###D#######O#OOOOOOEOO#OOOOOOOOO#
OOOOOOOOOOOOOOOOO###O#######O#OOOOOOOOO#OOOOOOOOO#
OOOOOOOOOOOOOOOOO#OOOOOOO#####OOO#######OOOOOOOOO#
OOOOOOOOOOOOOOOOO#OOOOOOO#O###OOO#OOOOOOOOOOOOOOO#
OOOOOOOOOOOOOOOOO#OOO##OOOO###OEO#OOOOOOOOOOOOOOO#
OOOOOOOOOOOOOOOOO#O####OOOOOOOOOO#OOOOOOOOOOOOOOO#
OOOOOOOOOOOOOOOOO#O##O#OOEOOOOOOO#OOOOOOOOOOOOOOO#
OOOOOOOOOOOOOOOOO#OO#OOOOOOOOOOOO#OOOOOOOOOOOOOOO#
OOOOOOOOOOOOOOOOO#################OOOOOOOOOOOOOOO#
OOOOOOOOOOOOOOOOOOOOOOOOOOOOOOOOOOOOOOOOOOOOOOOOO#
OOOOOOOOOOOOOOOOOOOOOOOOOOOOOOOOOOOOOOOOOOOOOOOOO#
OOOOOOOOOOOOOOOOOOOOOOOOOOOOOOOOOOOOOOOOOOOOOOOOO#
OOOOOOOOOOOOOOOOOOOOOOOOOOOOOOOOOOOOOOOOOOOOOOOOO#
OOOOOOOOOOOOOOOOOOOOOOOOOOOOOOOOOOOOOOOOOOOOOOOOO#
OOOOOOOOOOOOOOOOOOOOOOOOOOOOOOOOOOOOOOOOOOOOOOOOO#
OOOOOOOOOOOOOOOOOOOOOOOOOOOOOOOOOOOOOOOOOOOOOOOOO#
OOOOOOOOOOOOOOOOOOOOOOOOOOOOOOOOOOOOOOOOOOOOOOOOO#
OOOOOOOOOOOOOOOOOOOOOOOOOOOOOOOOOOOOOOOOOOOOOOOOO#
OOOOOOOOOOOOOOOOOOOOOOOOOOOOOOOOOOOOOOOOOOOOOOOOO#
OOOOOOOOOOOOOOOOOOOOOOOOOOOOOOOOOOOOOOOOOOOOOOOOO#
OOOOOOOOOOOOOOOOOOOOOOOOOOOOOOOOOOOOOOOOOOOOOOOOO#
OOOOOOOOOOOOOOOOOOOOOOOOOOOOOOOOOOOOOOOOOOOOOOOOO#
OOOOOOOOOOOOOOOOOOOOOOOOOOOOOOOOOOOOOOOOOOOOOOOOO#
OOOOOOOOOOOOOOOOOOOOOOOOOOOOOOOOOOOOOOOOOOOOOOOOO#
OOOOOOOOOOOOOOOOOOOOOOOOOOOOOOOOOOOOOOOOOOOOOOOOO#
OOOOOOOOOOOOOOOOOOOOOOOOOOOOOOOOOOOOOOOOOOOOOOOOO#
OOOOOOOOOOOOOOOOOOOOOOOOOOOOOOOOOOOOOOOOOOOOOOOOO#
OOOOOOOOOOOOOOOOOOOOOOOOOOOOOOOOOOOOOOOOOOOOOOOOO#
OOOOOOOOOOOOOOOOOOOOOOOOOOOOOOOOOOOOOOOOOOOOOOOOO#
