OOOOOOOOOOOOOOOOOOOOOOOOOOOOOOOOOOOOOOOOOOOOOOOOO#
OOOOOOOOOOOOOOOOOOOOOOOOOOOOOOOOOOOOOOOOOOOOOOOOO#
OOOOOOOOOOOOOOOOOOOOOOOOOOOOOOOOOOOOOOOOOOOOOOOOO#
OOOOOOOOOOOOOOOOOOOOOOOOOOOOOOOOOOOOOOOOOOOOOOOOO#
OOOOOOOOOOOOOOOOOOOOOOOOOOOOOOOOOOOOOOOOOOOOOOOOO#
OOOOOOOOOOOOOOOOOOOOOOOOOOOOOOOOOOOOOOOOOOOOOOOOO#
OOOOOOOOOOOOOOOOOOOOOOOOOOOOOOOOOOOOOOOOOOOOOOOOO#
OOOOOOOOOOOOOOOOOOOOOOOOOOOOOOOOOOOOOOOOOOOOOOOOO#
OOOOOOOOOOOOOOOOOOOOOOOOOOOOOOOOOOOOOOOOOOOOOOOOO#
OOOOOOOOOOOOOOOOOOOOOOOOOOOOOOOOOOOOOOOOOOOOOOOOO#
OOOOOOOOOOOOOOOOOOOOOOOOOOOOOOOOOOOOOOOOOOOOOOOOO#
OOOOOOOOOOOOOOOOOOOOOOOOOOOOOOOOOOOOOOOOOOOOOOOOO#
OOOOOOOOOOOOOOOOOOOOOOOOOOOOOOOOOOOOOOOOOOOOOOOOO#
OOOOOOOOOOOOOOOOOOOOOOOOOOOOOOOOOOOOOOOOOOOOOOOOO#
OOOOOOOOOOOOOOOOOOOOOOOOOOOOOOOOOOOOOOOOOOOOOOOOO#
OOOOOOOOOOOOOOOOOOOOOOOOOOOOOOOOOOOOOOOOOOOOOOOOO#
OOOOOOOOOOOOOOOOOOOOOOOOOOOOOOOOOOOOOOOOOOOOOOOOO#
OOOOOOOOOOOOOOOOOOO#######OOOOOOOOOOOOOOOOOOOOOOO#
OOOOOOOOOOOOOOOOOOO#######OOOOOOOOOOOOOOOOOOOOOOO#
OOOOOOOOOOOOOOOOOOO#######OOOOOOOOOOOOOOOOOOOOOOO#
OOOOOOOOOOOOOOOOOOO#OODOO#OOOOOOOOOOOOOOOOOOOOOOO#
OOOOOOOOOOOOOOOOOOO#OOOOO#OOOOOOOOOOOOOOOOOOOOOOO#
OOOOOOOOOOOOOOOOOOO#OOOOO#OOOOOOOOOOOOOOOOOOOOOOO#
OOOOOOOOOOOOOOOOOOO#OOEOO#OOOOOOOOOOOOOOOOOOOOOOO#
OOOOOOOOOOOOOOOOOOO#OOOOO############OOOOOOOOOOOO#
OOOOOOOOOOOOOOOOOOO#OOOOO########O###OOOOOOOOOOOO#
OOOOOOO#######OOOOO#OOOOO############OOOOOOOOOOOO#
OOOOOOO#OOOOO#######OOOOOO######OOOO##OOOOOOOOOOO#
OOOOOOO######OOOOOO#OOOEOOO#O#O#OOOOD#OOOOOOOOOOO#
OOOOOOO##OOO########OOOOOOO##O###OOO##OOOOOOOOOOO#
OOOOOOO#OOOOO#OOOOOOOOOOOOOO#O#OOOOO#OOOOOOOOOOOO#
OOOOOOO####OOOOONOOOOOOO########OOOO#OOOOOOOOOOOO#
OOOOOOO####O########OEOO########OEOO#OOOOOOOOOOOO#
OOOOOOO#OOOO##OOOOO#OOOO########OOOO#OOOOOOOOOOOO#
OOOOOOO##OO##OOOOOO#OOOO########OOOO#OOOOOOOOOOOO#
OOOOOOOO#O##OOOOOOO#OOOO########OOOO#OOOOOOOOOOOO#
OOOOOOOO#O##OOOOOOO#OOOO########OOOO##########OOO#
OOOOOOOO#OO#OOOOOOO#OOOO########OOOO#OOOOOOOO#OOO#
OOOOOOOO#OO#OOOOOOO#OOOO########OOOO########O#OOO#
OOOOOOOO#OO#OOOOOOO#OOOOOOOOO##OOOOOOO########OOO#
OOOOOO###OO#OOOOOOO#OOEOOOOOOOOOOOEOOOOOOO####OOO#
OOOOOO#D#OO#########OOOOOOEOO##OOOOOOOEOOO#O##OOO#
OOOOOO#O#OO###########OOOOOOO##OOOOOOOOOOOOO###OO#
OOOOOO#OOOOO##########OO###############OOOOOOD#OO#
OOOOOO####OOOOOOOOOOOOOO#OOOOOOOOOOOOO#OOEOOO##OO#
OOOOOO####OOOOOOOOOOOOOO#OOOOOOOOOOOOO#OOOOOO#OOO#
OOOOOO#OOOO##############OOOOOOOOOOOOO########OOO#
OOOOOO#OOOO##OOOOOOOOOOOOOOOOOOOOOOOOOOOOOOOOOOOO#
OOOOOO#######OOOOOOOOOOOOOOOOOOOOOOOOOOOOOOOOOOOO#
OOOOOOOOOOOOOOOOOOOOOOOOOOOOOOOOOOOOOOOOOOOOOOOOO#
